15 15
0 0
6 6 6 6 6 6 6 6 6 6 6 6 6 6 6 
6 7 6 6 7 7 4 4 4 7 7 6 6 7 6
6 6 6 7 7 7 4 4 4 7 7 7 6 6 6
6 6 7 5 5 5 4 4 4 5 5 5 7 6 6
6 7 7 5 5 5 4 4 4 5 5 5 7 7 6
6 7 7 5 5 5 4 4 4 5 5 5 7 7 6
6 4 4 4 4 4 4 4 4 4 4 4 4 4 6
6 4 4 4 4 4 4 4 4 4 4 4 4 4 6
6 4 4 4 4 4 4 4 4 4 4 4 4 4 6
6 7 7 5 5 5 4 4 4 5 5 5 7 7 6
6 7 7 5 5 5 4 4 4 5 5 5 7 7 6
6 6 7 5 5 5 4 4 4 5 5 5 7 6 6
6 6 6 7 7 7 4 4 4 7 7 7 6 6 6
6 7 6 6 7 7 4 4 4 7 7 6 6 7 6
6 6 6 6 6 6 6 6 6 6 6 6 6 6 6