15 15
0 0
6 6 6 6 6 6 6 6 6 6 6 6 6 6 6 
6 7 7 7 6 4 4 4 4 6 4 4 5 5 6
6 7 7 7 6 4 4 4 4 6 7 5 5 5 6
6 7 7 7 6 7 4 4 4 6 7 7 7 5 6
6 7 7 7 6 4 4 4 4 6 6 6 7 5 6
6 6 7 7 6 6 4 4 4 6 7 7 5 5 6
6 7 7 7 7 7 7 7 7 7 7 7 5 5 6
6 7 7 7 7 7 7 7 7 7 6 6 5 5 6
6 7 7 7 7 7 7 7 5 7 5 5 5 5 6
6 6 7 5 5 5 6 7 7 7 6 5 5 5 6
6 7 7 5 5 5 7 7 7 7 6 7 7 7 6
6 7 5 6 5 5 7 7 7 7 6 7 7 7 6
6 6 7 5 7 7 6 7 7 6 6 7 7 6 6
6 7 7 7 7 7 6 7 7 7 6 7 7 7 6
6 6 6 6 6 6 6 6 6 6 6 6 6 6 6