15 15
0 0
6 6 6 6 6 6 6 6 6 6 6 6 6 6 6 
6 4 4 4 6 4 4 4 4 6 4 4 4 5 6
6 4 4 4 4 4 4 4 4 6 5 5 5 4 6
6 4 4 4 4 4 4 4 4 6 4 5 4 5 6
6 4 4 4 4 5 4 4 4 6 6 6 4 4 6
6 6 4 4 4 6 4 4 4 6 4 4 4 4 6
6 4 4 4 4 5 4 4 4 6 4 4 4 4 6
6 4 4 4 4 4 4 4 4 6 5 5 5 4 6
6 4 4 4 4 4 4 4 5 6 5 5 5 5 6
6 6 4 4 4 4 6 4 4 6 5 5 5 5 6
6 4 4 4 5 5 4 4 4 4 5 5 5 5 6
6 4 5 4 4 5 4 5 5 5 5 5 5 5 6
6 6 6 4 4 4 5 5 5 6 6 6 6 6 6
6 4 4 4 4 4 6 5 5 5 5 5 5 5 6
6 6 6 6 6 6 6 6 6 6 6 6 6 6 6